1,2,,,,,,,,,,,,,,,,,,
2,1,1,1,1,1,1,1,1,1,1,1,1,1,1,1,1,1,0,2
2,0,0,0,0,0,0,0,0,0,0,0,0,0,0,0,0,1,0,2
2,0,0,1,0,0,0,0,0,0,0,0,0,0,0,0,0,1,0,2
2,0,0,0,0,0,0,0,0,0,0,0,0,0,0,0,0,1,0,2
2,0,0,0,0,0,0,0,0,0,0,0,0,0,0,0,0,0,0,2
2,0,0,0,0,0,0,0,0,0,0,0,0,0,0,0,0,0,0,2
2,0,0,1,0,0,0,0,0,0,1,0,0,0,0,0,0,0,0,2
2,1,0,0,1,0,1,0,1,0,0,0,0,1,0,0,1,1,1,2
2,0,0,0,0,0,0,0,0,0,0,0,0,0,0,0,0,0,0,2
2,0,0,0,0,0,0,0,0,0,0,0,0,0,0,0,0,0,0,2
2,0,0,0,0,0,0,0,0,0,1,0,0,1,0,1,0,0,1,2
2,0,0,0,0,0,0,0,1,0,0,0,0,0,0,0,0,0,0,2
2,0,0,0,0,0,1,0,0,0,0,0,0,0,0,0,0,0,0,2
2,0,0,0,1,0,0,0,0,0,0,0,0,0,0,0,0,0,1,2
2,0,1,0,0,0,0,0,0,0,0,0,0,0,0,0,0,0,0,2
,,,,,,,,,,,,,,,,,,,
3,,,,,,,,,,,,,,,,,,,
18,12,1,2,1,,,,,,,,,,,,,,,
3,2,1,2,2,,,,,,,,,,,,,,,
17,4,1,3,0,,,,,,,,,,,,,,,
,,,,,,,,,,,,,,,,,,,
2,,,,,,,,,,,,,,,,,,,
18,13,0,0,1,,,,,,,,,,,,,,,
3,3,1,0,2,,,,,,,,,,,,,,,
,,,,,,,,,,,,,,,,,,,
,,,,,,,,,,,,,,,,,,,
,,,,,,,,,,,,,,,,,,,
2,,,,,,,,,,,,,,,,,,,
18,12,0,1,2,1,,,,,,,,,,,,,,
3,2,0,1,3,1,,,,,,,,,,,,,,
,,,,,,,,,,,,,,,,,,,
,,,,,,,,,,,,,,,,,,,
,,,,,,,,,,,,,,,,,,,
,,,,,,,,,,,,,,,,,,,