1,0,,,,,,,,,,,,,,,,,,
2,0,0,0,0,0,0,0,0,0,0,0,0,0,0,0,0,0,0,2,
2,0,0,0,0,0,0,0,0,0,0,0,0,0,0,0,0,0,0,2,
2,0,0,0,0,0,0,0,0,0,1,1,1,1,1,1,1,1,1,2,
2,0,0,0,0,0,0,0,0,1,1,1,1,0,0,0,1,1,0,2,
2,0,0,0,0,0,0,0,0,0,0,1,0,0,0,0,1,0,0,2,
2,0,0,0,0,0,0,0,0,0,0,0,0,0,0,0,0,0,0,2,
2,0,0,0,0,0,0,0,0,0,0,0,0,0,0,0,0,0,0,2,
2,0,0,0,0,0,0,0,0,0,0,0,0,0,0,0,0,0,0,2,
2,0,0,0,0,0,0,0,0,0,0,0,0,0,0,0,0,0,0,2,
2,0,0,0,0,0,0,0,1,1,1,1,1,1,0,0,0,0,0,2,
2,0,0,0,0,0,0,1,1,1,1,0,0,0,0,0,0,0,0,2,
2,0,0,0,0,0,1,1,0,0,0,0,0,0,0,0,0,0,0,2,
2,0,0,0,0,1,1,0,0,0,0,0,0,0,0,0,0,0,0,2,
2,0,0,0,1,1,1,0,0,0,0,0,0,0,0,0,0,0,0,2,
2,0,0,1,1,1,0,0,0,0,1,1,1,1,1,1,1,1,1,2,
,,,,,,,,,,,,,,,,,,,
2,,,,,,,,,,,,,,,,,,,
12,11,1,2,0,,,,,,,,,,,,,,,
14,7,0,4,0,,,,,,,,,,,,,,,
,,,,,,,,,,,,,,,,,,,
0,,,,,,,,,,,,,,,,,,,
,,,,,,,,,,,,,,,,,,,
,,,,,,,,,,,,,,,,,,,
,,,,,,,,,,,,,,,,,,,
,,,,,,,,,,,,,,,,,,,
,,,,,,,,,,,,,,,,,,,
0,,,,,,,,,,,,,,,,,,,
,,,,,,,,,,,,,,,,,,,
,,,,,,,,,,,,,,,,,,,
,,,,,,,,,,,,,,,,,,,
,,,,,,,,,,,,,,,,,,,
,,,,,,,,,,,,,,,,,,,
,,,,,,,,,,,,,,,,,,,