0,0,,,,,,,,,,,,,,,,,,
2,1,1,1,1,1,1,1,1,1,1,1,0,0,0,0,0,0,0,2
2,0,0,0,0,0,0,0,0,0,0,1,0,0,0,0,0,0,0,2
2,0,0,0,0,0,0,0,0,0,0,1,0,0,0,0,0,0,0,2
2,0,0,0,0,0,0,0,0,0,0,1,0,0,0,0,0,0,0,2
2,0,0,0,0,0,0,0,0,0,0,1,0,0,0,0,0,0,0,2
2,0,0,0,0,0,0,0,1,0,0,1,0,0,0,0,1,1,1,2
2,0,0,0,0,0,0,0,0,0,0,0,0,0,0,1,1,1,1,2
2,0,0,0,0,0,0,0,0,0,0,0,0,0,1,1,1,1,1,2
2,0,0,0,0,0,0,0,0,0,0,0,0,1,1,1,1,1,1,2
2,0,0,0,0,0,0,0,0,0,0,0,1,1,1,1,1,1,1,2
2,0,0,0,0,0,0,0,0,0,0,1,1,1,1,1,1,1,1,2
2,0,0,0,0,0,0,0,0,0,1,1,1,1,1,1,1,1,1,2
2,0,0,0,0,0,0,0,0,1,1,1,1,1,1,1,1,1,1,2
2,0,0,0,0,0,0,0,1,1,1,1,1,1,1,1,1,1,1,2
2,0,0,1,1,1,1,1,1,1,1,1,1,1,1,1,1,1,1,2
,,,,,,,,,,,,,,,,,,,
2,,,,,,,,,,,,,,,,,,,
7,7,1,5,1,,,,,,,,,,,,,,,
4,2,1,3,0,,,,,,,,,,,,,,,
,,,,,,,,,,,,,,,,,,,
1,,,,,,,,,,,,,,,,,,,
18,5,0,0,1,,,,,,,,,,,,,,,
,,,,,,,,,,,,,,,,,,,
,,,,,,,,,,,,,,,,,,,
,,,,,,,,,,,,,,,,,,,
,,,,,,,,,,,,,,,,,,,
2,,,,,,,,,,,,,,,,,,,
18,5,0,1,2,0,,,,,,,,,,,,,,
7,7,0,1,2,1,,,,,,,,,,,,,,
,,,,,,,,,,,,,,,,,,,
,,,,,,,,,,,,,,,,,,,
,,,,,,,,,,,,,,,,,,,
,,,,,,,,,,,,,,,,,,,